abbreviation	full name	smiles
3-chlorophenylalanine	3-chlorophenylalanine	
4-acetamidopyrrole-2-carboxylic acid	4-acetamidopyrrole-2-carboxylic acid	
glutamic acid	glutamic acid	
N5-hydroxyornithine	N5-hydroxyornithine	
4R-methylproline	4R-methylproline	
2,4-diaminobutyric acid	2,4-diaminobutyric acid	
2-fluorophenylalanine	2-fluorophenylalanine	
4-methoxytryptophan	4-methoxytryptophan	
3-hydroxy-O-methyltyrosine	3-hydroxy-O-methyltyrosine	
D-pipecolic acid	D-pipecolic acid	
N-formylglycine	N-formylglycine	
arginine	arginine	
(E)-4-methylhex-2-enoic acid	(E)-4-methylhex-2-enoic acid	
2-hydroxy-4-methylpentanoic acid	2-hydroxy-4-methylpentanoic acid	
S-beta-hydroxyphenylalanine	S-beta-hydroxyphenylalanine	
3-chlorotyrosine	3-chlorotyrosine	
4-hydroxyindole-3-carboxylic acid	4-hydroxyindole-3-carboxylic acid	
3-aminoisobutyric acid	3-aminoisobutyric acid	
homoleucine	homoleucine	
3-chloro-N-methylalanine	3-chloro-N-methylalanine	
N5-acetyl-N5-hydroxyornithine	N5-acetyl-N5-hydroxyornithine	
N5-cis-anhydromevalonyl-N5-hydroxyornithine	N5-cis-anhydromevalonyl-N5-hydroxyornithine	
2,4-dihydroxypentanoic acid	2,4-dihydroxypentanoic acid	
6S-methyl-pipecolic acid	6S-methyl-pipecolic acid	
homophenylalanine	homophenylalanine	
3-hydroxyleucine	3-hydroxyleucine	
4-oxoproline	4-oxoproline	
2-chlorophenylalanine	2-chlorophenylalanine	
alanine	alanine	
2-amino-3,5-dimethyl-4-hexenoic Acid	2-amino-3,5-dimethyl-4-hexenoic Acid	
N5-formyl-N5-hydroxyornithine	N5-formyl-N5-hydroxyornithine	
threonine	threonine	
2-(1-methylcyclopropyl)-D-glycine	2-(1-methylcyclopropyl)-D-glycine	
3-hydroxyquinaldic acid	3-hydroxyquinaldic acid	
3S-hydroxyproline	3S-hydroxyproline	
pentanoic acid	pentanoic acid	
benzoxazolinate	benzoxazolinate	
N-methylserine	N-methylserine	
graminine	graminine	
3-hydroxykynurenine	3-hydroxykynurenine	
piperazic acid	piperazic acid	
5-aminolevulinic acid	5-aminolevulinic acid	
p-hydroxymandelate	p-hydroxymandelate	
5R-hydroxy-2S-aminopentanoic acid	5R-hydroxy-2S-aminopentanoic acid	
(S,E)-2-amino-4-decenoic acid	(S,E)-2-amino-4-decenoic acid	
D-phenyllactic acid	D-phenyllactic acid	
asparagine	asparagine	
butyric acid	butyric acid	
2-aminoisobutyric acid	2-aminoisobutyric acid	
betaine	betaine	
2-aminobutyric acid	2-aminobutyric acid	
5,5-dimethylpipecolic acid	5,5-dimethylpipecolic acid	
malic acid	malic acid	
2-carboxy-6-hydroxyoctahydroindole	2-carboxy-6-hydroxyoctahydroindole	
valine	valine	
4,5-dihydroxyornithine	4,5-dihydroxyornithine	
4S-methylazetidine-2S-carboxylic acid	4S-methylazetidine-2S-carboxylic acid	
6-chloro-4-hydroxy-1-methyl-indole-3-carboxylic acid	6-chloro-4-hydroxy-1-methyl-indole-3-carboxylic acid	
4-methylproline	4-methylproline	
4-hydroxyglutamine	4-hydroxyglutamine	
3S-hydroxy-4S-methylproline	3S-hydroxy-4S-methylproline	
succinic semialdehyde	succinic semialdehyde	
2-amino-6-hydroxy-4-methyl-8-oxodecanoic acid	2-amino-6-hydroxy-4-methyl-8-oxodecanoic acid	
4-hydroxyproline	4-hydroxyproline	
phenylpyruvic acid	phenylpyruvic acid	
N5-nitroso-N5-hydroxyornithine	graminine	
2-ketoisocaproic acid	2-ketoisocaproic acid	
3S-methylproline	3S-methylproline	
lysine	lysine	
R-beta-methyltryptophan	R-beta-methyltryptophan	
2,3-diamino-3-methylpropanoic acid	2,3-diamino-3-methylpropanoic acid	
3-methylasparagine	3-methylasparagine	
An acid hydrazine polyene (intermediate 14)	An acid hydrazine polyene (intermediate 14)	
3-hydroxy-O-methyl-5-methyltyrosine	3-hydroxy-O-methyl-5-methyltyrosine	
aspartic acid	aspartic acid	
anthranillic acid	anthranilic acid	
2S,3S-diaminobutyric acid	2S,3S-diaminobutyric acid	
(4S)-5,5,5-trichloroleucine	(4S)-5,5,5-trichloroleucine	
3-nitrotyrosine	3-nitrotyrosine	
proline	proline	
2-methylserine	2-methylserine	
2-sulfamoylacetic acid	2-sulfamoylacetic acid	
3,5-dihydroxyphenylglycine	3,5-dihydroxyphenylglycine	
D-aspartic acid branched	D-aspartic acid branched	
3R-hydroxyhomotyrosine	3R-hydroxyhomotyrosine	
2,3-diaminopropionic acid	2,3-diaminopropionic acid	
anthranilic acid	anthranilic acid	
N-(1-propargyl)-tryptophan	N-(1-propargyl)-tryptophan	
2,5-dihydroxy-4-methylpentanoic acid	2,5-dihydroxy-4-methylpentanoic acid	
3-methylleucine	3-methylleucine	
3S-hydroxyleucine	3S-hydroxyleucine	
capreomycidine	capreomycidine	
O-methyltyrosine	O-methyltyrosine	
2R-hydroxyisovaleric acid	2R-hydroxyisovaleric acid	
2-hydroxy-4-methylpentanedioic acid	2-hydroxy-4-methylpentanoic acid	
para-aminobenzoic acid	para-aminobenzoic acid	
R-beta-methylphenylalanine	R-beta-methylphenylalanine	
2-hexenoic acid	2-hexenoic acid	
aMe-phenylalanine	alpha-methylphenylalanine	
5S-methylproline	5S-methylproline	
3-(2-nitrocyclopropylalanine)	3-(2-nitrocyclopropylalanine)	
serine	serine	
histidine	histidine	
3,5-dichloro-4-hydroxyphenylglycine	3,5-dichloro-4-hydroxyphenylglycine	
3R-aminoisobutyric acid	3R-methylbeta-alanine	
4R-hydroxyproline	4R-hydroxyproline	
beta-hydroxy-3-hydroxy-O-methyl-5-methyltyrosine	beta-hydroxy-3-hydroxy-O-methyl-5-methyltyrosine	
enduracididine	enduracididine	
4R-propylproline	4R-propylproline	
phenazine-1-carboxylic acid	phenazine-1-carboxylic acid	
3-hydroxytyrosine	3-hydroxytyrosine	
isovaleric acid	isovaleric acid	
benzoic acid	benzoic acid	
3R-hydroxyaspartic acid	3R-hydroxyaspartic acid	
4R-butenyl-4R-methylthreonine	4R-E-butenyl-4R-methylthreonine	
4-amino-2-hydroxy-3-isopropoxybenzoic acid	4-amino-2-hydroxy-3-isopropoxybenzoic acid	
succinyl-hydrazinoacetic acid	succinyl-hydrazinoacetic acid	
D-glutamic acid branched	D-glutamic acid branched	
allo-isoleucine	allo-isoleucine	
guanidinoacetic acid	guanidinoacetic acid	
4-aminobutyric acid	4-aminobutyric acid	
D-glutamine	D-glutamine	
3R-hydroxy-2,4-diaminobutyric acid	3R-hydroxy-2,4-diaminobutyric acid	
1-aminocyclopropane-1-carboxylic acid (ACC)	1-aminocyclopropane-1-carboxylic acid	
homotyrosine	homotyrosine	
glycine	glycine	
2-chlorobenzoic acid	2-chlorobenzoic acid	
4S-hydroxylysine	4S-hydroxylysine	
phenazine-1,6-dicarboxylic acid	phenazine-1,6-dicarboxylic acid	
fatty acid	fatty acid	
2S-hydroxyisovaleric acid	2S-hydroxyisovaleric acid	
p-hydroxybenzoylformic acid	p-hydroxybenzoylformic acid	
3S-methyl-D-aspartic acid branched	3S-methyl-D-aspartic acid branched	
3R-hydroxyasparagine	3R-hydroxyasparagine	
2-hydroxypent-4-enoic acid	2-hydroxypent-4-enoic acid	
N6-hydroxylysine	N6-hydroxylysine	
3-hydroxybenzoic acid	3-hydroxybenzoic acid	
2,3-dihydroxybenzoic acid	2,3-dihydroxybenzoic acid	
3-hydroxyaspartic acid	3-hydroxyaspartic acid	
4-aminophenylalanine	4-aminophenylalanine	
4S-propenylproline	4S-propenylproline	
dehydrotryptophan	dehydrotryptophan	
3,4-dehydroproline	3,4-dehydroproline	
beta-hydroxyphenylalanine	beta-hydroxyphenylalanine	
3-hydroxypicolinic acid	3-hydroxypicolinic acid	
dimethylsulfoniopropionic acid	dimethylsulfoniopropionic acid	
lactic acid	lactic acid	
citrulline	citrulline	
3R-methyl-D-aspartic acid branched	3R-methyl-D-aspartic acid branched	
hydroxyproline	hydroxyproline	
3-hydroxyasparagine	3-hydroxyasparagine	
3-hydroxy-4-methylproline	3-hydroxy-4-methylproline	
4-bromophenylalanine	4-bromophenylalanine	
3-(3-pyridyl)-alanine	3-(3-pyridyl)-alanine	
4-hydroxy-D-kynurenine	4-hydroxy-D-kynurenine	
N1-methoxytryptophan	N1-methoxytryptophan	
(2S,3R)-2-amino-3-hydroxy-4-(4-nitrophenyl)butanoic acid	(2S,3R)-2-amino-3-hydroxy-4-(4-nitrophenyl)butanoic acid	
hexanoic acid	hexanoic acid	
coumaric acid	coumaric acid	
R-aza-beta-tyrosine	R-aza-beta-tyrosine	
(2S, 8S)-2-amino-8-hydroxydecanoic	2S-amino-8S-hydroxydecanoic acid	
R-beta-tyrosine	R-beta-tyrosine	
3S,4R-dichloroproline	3S,4R-dichloroproline	
D-leucine	D-leucine	
quinoxaline-2-carboxylic acid	quinoxaline-2-carboxylic acid	
beta-lysine	beta-lysine	
N-hydroxyvaline	N-hydroxyvaline	
3,4-dihydroxybenzoic acid	3,4-dihydroxybenzoic acid	
S-beta-hydroxycyclohex-2S-enylalanine	S-beta-hydroxycyclohex-2S-enylalanine	
norcoronamic acid	norcoronamic acid	
anthanillic acid	anthranilic acid	
aspartic acid branched	aspartic acid branched	
salicylic acid	salicylic acid	
leucine	leucine	
N-dimethylglycine	N-dimethylglycine	
cysteine	cysteine	
1-pyrroline-5-carboxylic acid	1-pyrroline-5-carboxylic acid	
5-methoxytyrosine	5-methoxytyrosine	
6,7-dichlorotryptophan	6,7-dichlorotryptophan	
tryptophan	tryptophan	
4-chlorobenzoic acid	4-chlorobenzoic acid	
4S-acetyl-5S-methylproline	4S-acetyl-5S-methylproline	
6-chlorotryptophan	6-chlorotryptophan	
3-methylaspartic acid	3-methylaspartic acid	
D-allo-threonine	D-allo-threonine	
2S-amino-8-oxodecanoic acid	2S-amino-8-oxodecanoic acid	
N-(1-methyl)-tryptophan	N-(1-methyl)-tryptophan	
3S-hydroxyasparagine	3S-hydroxyasparagine	
2-ketoisovaleric acid	2-ketoisovaleric acid	
cinnamic acid	cinnamic acid	
R-beta-hydroxyphenylalanine	R-beta-hydroxyphenylalanine	
3S-methylaspartic acid	3S-methylaspartic acid	
glutamine	glutamine	
2-ketobutyric acid	2-ketobutyric acid	
4S-methylproline	4S-methylproline	
azetidine-2-carboxylic acid	azetidine-2-carboxylic acid	
3-amino-6-hydroxy-2-piperidone	3-amino-6-hydroxy-2-piperidone	
R-beta-hydroxytyrosine	R-beta-hydroxytyrosine	
3-hydroxyglutamine	3-hydroxyglutamine	
2-ketoglutaric acid	2-ketoglutaric acid	
alpha-methylphenylalanine	alpha-methylphenylalanine	
D-alpha-aminobutyric acid	D-2-aminobutyric acid	
hydrocinnamic acid	hydrocinnamic acid	
D-2,3-diaminopropionic acid	D-2,3-diaminopropionic acid	
pipecolic acid	pipecolic acid	
3-methoxyanthranilic acid	3-methoxyanthranilic acid	
2-amino-decanoic acid	2S-aminodecanoic acid	
(2S,6R)-diamino-(5R,7)-dihydroxy-heptanoic acid	(2S,6R)-diamino-(5R,7)-dihydroxy-heptanoic acid	
isoleucine	isoleucine	
3R-hydroxyleucine	3R-hydroxyleucine	
4-chlorothreonine	4-chlorothreonine	
D-alanine	D-alanine	
3-methoxyaspartic acid	3-methoxyaspartic acid	
pyruvic acid	pyruvic acid	
S-adenosylmethionine	S-adenosylmethionine	
octanoic acid	octanoic acid	
glycolic acid	glycolic acid	
N-formylalanine	N-formylalanine	
4-hydroxybenzoic acid	4-hydroxybenzoic acid	
linoleic acid	linoleic acid	
5-methylorsellinic acid	5-methylorsellinic acid	
D-phenylalanine	D-phenylalanine	
3R-methylglutamic acid	3R-methylglutamic acid	
ornithine	ornithine	
N5-trans-anhydromevalonyl-N5-hydroxyornithine	N5-trans-anhydromevalonyl-N5-hydroxyornithine	
2S-amino-9,10-epoxy-8-oxodecanoic acid	2S-amino-9,10-epoxy-8-oxodecanoic acid	
beta-hydroxytyrosine	beta-hydroxytyrosine	
alaninol	alaninol	
3S-carboxypiperazine	piperazic acid	
4-methylphenylalanine	4-methylphenylalanine	
S-beta-hydroxyenduracididine	S-beta-hydroxyenduracididine	
cysteine branched	cysteine branched	
4-nitrotryptophan	4-nitrotryptophan	
homoserine	homoserine	
cysteic acid	cysteic acid	
dehydrophenylalanine	dehydrophenylalanine	
4-hydroxyphenylglycine	4-hydroxyphenylglycine	
2-aminoadipic acid	2-aminoadipic acid	
1-(1,1-dimethylallyl)-tryptophan	1-(1,1-dimethylallyl)-tryptophan	
2-amino-3-hydroxycyclopent-2-enone	2-amino-3-hydroxycyclopent-2-enone	
2-chloro-3,5-dihydroxy-4-methylphenylglycine	2-chloro-3,5-dihydroxy-4-methylphenylglycine	
3-amino-4-hydroxybenzoic acid	3-amino-4-hydroxybenzoic acid	
2,3-dihydroxyhexadecanoic acid	2,3-dihydroxyhexadecanoic acid	
3R-chloroproline	3R-chloroproline	
beta-hydroxyarginine	beta-hydroxyarginine	
5-chloroanthranilic acid	5-chloroanthranilic acid	
2S-hydroxyisocaproic acid	2S-hydroxyisocaproic acid	
3-hydroxyvaline	3-hydroxyvaline	
4-hydroxy-3-nitrobenzoic acid	4-hydroxy-3-nitrobenzoic acid	
4-hydroxyphenylpyruvic acid	4-hydroxyphenylpyruvic acid	
meta-tyrosine	meta-tyrosine	
6-methylsalicylic acid	6-methylsalicylic acid	
5-chlorotryptophan	5-chlorotryptophan	
3-fluorophenylalanine	3-fluorophenylalanine	
3-aminobenzoic acid	3-aminobenzoic acid	
methionine	methionine	
dehydrolysine	dehydrolysine	
2S-amino decanoic acid	2S-aminodecanoic acid	
2S-methyl-3-oxobutyrine	2S-methyl-3-oxobutyrine	
acetic acid	acetic acid	
dehydroarginine	dehydroarginine	
D-tyrosine	D-tyrosine	
1-aminocyclopropane-1-carboxylic acid	1-aminocyclopropane-1-carboxylic acid	
4,5-dehydroleucine	4,5-dehydroleucine	
2-octenoic acid	2-octenoic acid	
3S-cyclohex-2-enylalanine	3S-cyclohex-2-enylalanine	
phenylalanine	phenylalanine	
3-amino-2,4-dihydroxybenzoic acid	3-amino-2,4-dihydroxybenzoic acid	
3S,4S-dihydroxyhomotyrosine	3S,4S-dihydroxyhomotyrosine	
3R-methylbeta-alanine	3R-methylbeta-alanine	
2,3-dihydroxy-para-aminobenzoic acid	2,3-dihydroxy-para-aminobenzoic acid	
O-methylthreonine	O-methylthreonine	
3-hydroxy-para-aminobenzoic acid	3-hydroxy-para-aminobenzoic acid	
3S-hydroxy-6-chlorohistidine	3S-hydroxy-6-chlorohistidine	
kynurenine	kynurenine	
(S)-2-aminodecanoic acid	2S-aminodecanoic acid	
beta-alanine	beta-alanine	
4,5-dehydroarginine	4,5-dehydroarginine	
tyrosine	tyrosine	
2S-amino-dodecanoic acid	2S-aminododecanoic acid	
4-chlorophenylalanine	4-chlorophenylalanine	
2R-hydroxy-3-methylpentanoic acid	2R-hydroxy-3-methylpentanoic acid	
3-hydroxy-4-methoxyphenylalanine	3-hydroxy-O-methyltyrosine	
3S-hydroxypipecolic acid	3S-hydroxypipecolic acid	
2S-amino-octanoic-acid	2S-aminooctanoic acid	
D-arginine	D-arginine	
4-fluorophenylalanine	4-fluorophenylalanine	
S-beta-tyrosine	S-beta-tyrosine	
allo-threonine	allo-threonine	
trans-2-crotylglycine	trans-2-crotylglycine	
E-butenyl-4R-methylthreonine	4R-E-butenyl-4R-methylthreonine	
dehydrovaline	dehydrovaline	
3S-aminobutyric acid	3S-aminobutyric acid	
pyrrole-2-carboxylic acid	pyrrole-2-carboxylic acid	
phenylglycine	phenylglycine	
Compound 4 (formed by the decarboxylative condensation of L-Phe and succinyl-CoA)	Compound 4 (formed by the decarboxylative condensation of L-Phe and succinyl-CoA)	
2S-amino-4-hexenoic acid	2S-amino-4-hexenoic acid	
R-beta-phenylalanine	R-beta-phenylalanine	
nicotinic acid	nicotinic acid	