abbreviation	full name	smiles
OH-Orn	N5-hydroxyornithine	
Asp	aspartic acid	
Piz	piperazic acid	
dhDab	threonine	
aKiv	2-ketoisovaleric acid	
aThr	allo-threonine	
2Cl-Hpg	3,5-dichloro-4-hydroxyphenylglycine	
Ncp-Ala	3-(2-nitrocyclopropylalanine)	
Gca	glycolic acid	
Dhpg	3,5-dihydroxyphenylglycine	
3Me-Tyr	beta-methyltyrosine	CC(C1=CC=C(C=C1)O)[C@@H](C(=O)O)N
HOMM-Tyr	3-hydroxy-O-methyl-5-methyltyrosine	
Orn	ornithine	
Pip	pipecolic acid	
D-Lea	D-lysergic acid	CN1C[C@@H](C=C2C1CC3=CNC4=CC=CC2=C34)C(=O)O
PhGly	phenylglycine	
Iso	isoleucine	
Dhh-Tyr	3S,4S-dihydroxyhomotyrosine	
bOH-Tyr	beta-hydroxytyrosine	
Pac	phenylacetic acid	C1=CC=C(C=C1)CC(=O)O
bLys	beta-lysine	
O-Iv	2-ketoisovaleric acid	
NMe-Asp	N-methylaspartic acid	CN[C@@H](CC(=O)O)C(=O)O
NMe-Gly	N-methylglycine	
aMe-Ser	2-methylserine	
Alaol	alaninol	
Leu	leucine	
Ahnpb	(2S,3R)-2-amino-3-hydroxy-4-(4-nitrophenyl)butanoic acid	
aIle	allo-isoleucine	
4Me-Pro	4-methylproline	
Asn	asparagine	
Fo-OH-Orn	N5-formyl-N5-hydroxyornithine	
Bmt	4R-E-butenyl-4R-methylthreonine	
D-Ala	D-alanine	
gOH-Val	3-hydroxyvaline	
33p-Ala	3-(3-pyridyl)-alanine	
dhTyr	Z-dehydrotyrosine	C1=CC(=CC=C1/C=C(/C(=O)O)\N)O
Valol	valinol	CC(C)[C@@H](CO)N
4Pe-Pro	4S-propenylproline	
Gln	glutamine	
Gly	glycine	
OH-Asp	3-hydroxyaspartic acid	
Aad	2-aminoadipic acid	
His	histidine	
Ser	serine	
Thr	threonine	
bhceAla	S-beta-hydroxycyclohex-2S-enylalanine	
Hiv	2-hydroxyisovaleric acid	CC(C)C(C(=O)O)O
di-OH-Bz	2,3-dihydroxybenzoic acid	
dh-Thr	dehydrothreonine	C/C(=C(/C(=O)O)\N)/O
CysA	cysteic acid	
aKic	2-ketoisocaproic acid	
Phe	phenylalanine	
ddh-Arg	4,5-dehydroarginine	
Cys	cysteine	
OH-Asn	3-hydroxyasparagine	
3OH-Gln	3-hydroxyglutamine	
Met	methionine	
Dab	2,4-diaminobutyric acid	
Hpg	4-hydroxyphenylglycine	
Htyr	homotyrosine	
3Me-Asp	3-methylaspartic acid	
Kyn	kynurenine	
Trp	tryptophan	
4OH-Pro	4-hydroxyproline	
Ival	isovaline	NC(CC)(C)C(=O)O
Ac-Phe	N-acetylphenylalanine	CC(=O)N[C@@H](CC1=CC=CC=C1)C(=O)O
Aeo	2S-amino-9,10-epoxy-8-oxodecanoic acid	
Ile	isoleucine	
bTrp	beta-tryptophan	
Me-Dpr	2,3-diamino-3-methylpropanoic acid	
Hse	homoserine	
Val	valine	
bAla	beta-alanine	
6Cl-Hic	6-chloro-4-hydroxyindole-3-carboxylic acid	c1(Cl)cc2c(c(c1)O)c(c[nH]2)C(=O)O
bMe-Asp	3-methylaspartic acid	
NOH-Val	N-hydroxyvaline	
3OH-Leu	3-hydroxyleucine	
Lys	lysine	
bMe-Phe	beta-methylphenylalanine	C1=CC(=CC=C1)C(C)[C@@H](C(=O)O)N
4OH-5OH-Orn	4,5-dihydroxyornithine	
NOH-Ala	N-hydroxyalanine	C[C@@H](C(=O)O)NO
4p-Pro	4R-propylproline	
Cl2-Hpg	3,5-dichloro-4-hydroxyphenylglycine	
Hcn	hydrocinnamic acid	
Gac	guanidinoacetic acid	
Pro	proline	
norCMA	norcoronamic acid	
Sal	salicylic acid	
Arg	arginine	
Ala	alanine	
dhAbu	Z-dehydroaminobutyric acid	C/C=C(/C(=O)O)\N
Me-bAla	3R-methylbeta-alanine	
Glu	glutamic acid	
Tyr	tyrosine	
6Cl-Trp	6-chlorotryptophan	
Nme-Asp	N-methylaspartic acid	CN[C@@H](CC(=O)O)C(=O)O
3Me-Pro	3-methylproline	CC1CCN[C@@H]1C(=O)O
Glyco-cya	guanidinoacetic acid	
Abu	2-aminobutyric acid	
3Me-Glu	3-methylglutamic acid	CC(CC(=O)O)[C@@H](C(=O)O)N
3OH-3Me-Pro	3-hydroxy-3-methylproline	CC1(CCN[C@@H]1C(=O)O)O
bTyr	beta-tyrosine	